111111111111111111111111
100000000000000000000001
100000000000000000000001
100000000000000000000001
100000000000000000000001
100000000000000000000001
100000000000100000000001
100000000000000000000001
1000000000000000N0000001
100000000000000000000001
100000000000000000000001
100000000000000000000001
111111111111111111111111